# Syntax Coloring Map For RuntimeStorage

# Datatypes (KEYWORD1)
RuntimeStorage	KEYWORD1
PIDState	KEYWORD1
Event	KEYWORD1
TempReading	KEYWORD1
SystemState	KEYWORD1
MemoryHeader	KEYWORD1
Temperature_t	KEYWORD1
CounterType	KEYWORD1
RuntimeType	KEYWORD1
EventType	KEYWORD1
EventFilter	KEYWORD1

# Methods and Functions (KEYWORD2)
begin	KEYWORD2
isConnected	KEYWORD2
getSize	KEYWORD2
format	KEYWORD2
reset	KEYWORD2
getVersion	KEYWORD2
migrate	KEYWORD2
savePIDState	KEYWORD2
loadPIDState	KEYWORD2
incrementCounter	KEYWORD2
setCounter	KEYWORD2
getCounter	KEYWORD2
updateRuntimeHours	KEYWORD2
getRuntimeHours	KEYWORD2
logEvent	KEYWORD2
getEventCount	KEYWORD2
getEvents	KEYWORD2
clearEvents	KEYWORD2
recordTemperature	KEYWORD2
getTemperatureHistory	KEYWORD2
getLatestTemperature	KEYWORD2
saveSystemState	KEYWORD2
loadSystemState	KEYWORD2
writeBytes	KEYWORD2
readBytes	KEYWORD2
verifyIntegrity	KEYWORD2
printMemoryMap	KEYWORD2
getFreeSpace	KEYWORD2

# Constants (LITERAL1)
COUNTER_BURNER_STARTS	LITERAL1
COUNTER_HEATING_PUMP_STARTS	LITERAL1
COUNTER_WATER_PUMP_STARTS	LITERAL1
COUNTER_ERROR_COUNT	LITERAL1
COUNTER_MAX	LITERAL1
RUNTIME_TOTAL	LITERAL1
RUNTIME_HEATING	LITERAL1
RUNTIME_WATER	LITERAL1
RUNTIME_BURNER	LITERAL1
RUNTIME_MAX	LITERAL1
EVENT_ERROR	LITERAL1
EVENT_WARNING	LITERAL1
EVENT_STATE_CHANGE	LITERAL1
EVENT_USER_ACTION	LITERAL1
EVENT_SYSTEM	LITERAL1
EVENT_ALL	LITERAL1
ALL_EVENTS	LITERAL1
FRAM_MAGIC	LITERAL1
CURRENT_VERSION	LITERAL1